
NO ./get_map_greg/asset/sprites/sloth.xpm
SO ./get_map_greg/asset/sprites/wall.xpm

WE ./get_map_greg/asset/sprites/grass.xpm
EA ./get_map_greg/asset/sprites/herbs.xpm


F, 30, 45, 221
C 225,30,0

            1111111111111111111111111
            1000000000110000000000001
            1011000001110000000000001
      1111111001000000000000000000001
1111111110110000011100000000000011111
100000000011000001110111111111111
11110111111111011100000011011
11110111111111011101010010N01
11000000110101011100000010001
10000000000000001100000010001
10000000000000001101010010001
110000011101010111110110000111
11110111 1110101 101111010001 
11111111 1111111 111111111111