
NO ./get_map_greg/asset/sprites/exit.xpm
SO ./get_map_greg/asset/sprites/chat.xpm

WE ./get_map_greg/asset/sprites/chat.xpm
EA ./get_map_greg/asset/sprites/chat.xpm


F, 30, 45, 221
C 225,30,0

            11111111111111111111111111111111111
            10000000001100000000000011111111101
            10110000011100000000000011111111101
      11111110010000000000000000000011111111101
11111111101100000111000000000000111111111111101
10000000001100000111011111111111111111111111101
11110111111111011100000011011111111111111111101
11110111111111011101010010E11111111111111111101
11000000110101011100000010001111111111111111101
10000000000000001100000010001111111    11111101
10000000000000001101010010001111111111111111101
11000001110101011111011000011111111111111111101
11110111 1110101 101111010000000000000000000001 
11111111 1111111 111111111111111111111111111111