C 225,30,0
1111111111
1000000001
 111110001
    111011