11111111001
10000000001
10000111001
11111000001
11111000101
1111100P001
11111111001
11111111001
