
NO ./get_map_greg/asset/sprites/sloth.xpm
SO ./get_map_greg/asset/sprites/wall.xpm

WE ./get_map_greg/asset/sprites/grass.xpm
EA ./get_map_greg/asset/sprites/herbs.xpm


F, 60, 200, 90
C 60,100,200

            11111111111111111111111111111111111
            10000000001100000000000011111111101
            10110000011100000000000011111111101
      11111110010000000000000000000011111111101
11111111101100000111000000000000111111111111101
10000000001100000111011111111111111111111111101
11110111111111011100000011011111111111111111101
11110111111111011101010010N01111111111111111101
11000000110101011100000010001111111111111111101
10000000000000001100000010001111111    11111101
10000000000000001101010010001111111111111111101
11000001110101011111011000011111111111111111101
11110111 1110101 101111010000000000000000000001 
11111111 1111111 111111111111111111111111111111