
NO ./get_map_greg/asset/sprites/gravel.xpm
SO ./get_map_greg/asset/sprites/glass.xpm

EA ./get_map_greg/asset/sprites/wood.xpm

WE ./get_map_greg/asset/sprites/brick.xpm

F, 30, 45, 66
C, 225,30,45

      1111111111111111111111111
      1000000000110000000000001
      1011000001110000000000001
111111100100000000000000000000111
111111111011000001110000000000001
100000000011000001110111111111111
111101111111110111000000111111111
111101111111110111010100100111111
11000000110101011100N000100011111
100000000000000011000000100011111
100000000000000011010100100011111    
110000011101010111110110000111111
11110111 1110101 1011110100000001
11111111 1111111 1111111111111111