


SO ./get_map_greg/asset/sprites/wall.xpm

WE ./get_map_greg/asset/sprites/grass.xpm

EA ./get_map_greg/asset/sprites/herbs.xpm
F, 60, 200, 90
C 60,100,200
1111111111
1000000001
 111110N01
    111011
       1