
NO ./get_map_greg/asset/sprites/gravel.xpm
SO ./get_map_greg/asset/sprites/glass.xpm

EA ./get_map_greg/asset/sprites/wood.xpm

WE ./get_map_greg/asset/sprites/brick.xpm

F, 30, 45, 66
C, 225,30,45

1111111111        1111111111111
1E00000001        1000000000001
1111111001        1011110000001
      1001        101  10000001
      100111111111101  11111111
      100000000000001
      100000000001111
      11111111111