111111111111111111111
101000000000000000001
101000000000100101001
101000000000100E00111
100000000000110000001
100010000000100100001
100000001100010000001
100000000000000000001
111111111111111111111